11111111111
1111C0C1111
11110001111
11110001111
10000P00001
1C0000000C1
11110001111
11110001111
1111CEC1111
11111111111