11111111111
1101C0C1101
11110001111
111100E1111
10000P00001
1C0000000C1
11110001111
101100011C1
1111C0C1111
11111111111